0x0a 0x00 0xfa 0xff 0x33 0x00 0xf2 0xff 0xcb 0xff 0x1e 0x00 0xec 0xff 0xc0 0xff 0x05 0x00 0x1a 0x00 0xf4 0xff 0x22 0x00 0xf5 0xff 0x2c 0x00 0x29 0x00 0x19 0x00 
0x1b 0x00 0x28 0x00 0x03 0x00 0xe5 0xff 0xfa 0xff 0x10 0x00 0x03 0x00 0xaf 0xff 0xe1 0xff 0x1a 0x00 0xf9 0xff 0xe0 0xff 0x36 0x00 0x19 0x00 0x29 0x00 0xfc 0xff 
0xd6 0xff 0x28 0x00 0xd0 0xff 0xdc 0xff 0xfa 0xff 0xe6 0xff 0xe8 0xff 0xf2 0xff 0xdb 0xff 0x1a 0x00 0x0c 0x00 0x13 0x00 0x16 0x00 0x1b 0x00 0x29 0x00 0xb3 0xff 
0xd6 0xff 0x3b 0x00 0xd0 0xff 0xd3 0xff 0x08 0x00 0xdd 0xff 0xdf 0xff 0xf2 0xff 0xdb 0xff 0xf2 0xff 0x22 0x00 0x13 0x00 0xda 0xff 0x1c 0x00 0xe7 0xff 0xcb 0xff 
0xe4 0xff 0x2a 0x00 0xcf 0xff 0xfe 0xff 0xe3 0xff 0xdd 0xff 0xf9 0xff 0xf3 0xff 0xd0 0xff 0x02 0x00 0x34 0x00 0x2d 0x00 0xbd 0xff 0x1f 0x00 0xe3 0xff 0xfa 0xff 
0x51 0x00 0x15 0x00 0xd8 0xff 0xd3 0xff 0xe3 0xff 0xb6 0xff 0x15 0x00 0xf3 0xff 0xce 0xff 0xc2 0xff 0x3e 0x00 0xf8 0xff 0xcc 0xff 0x37 0x00 0xf8 0xff 0x29 0x00 
0xe3 0xff 0xe0 0xff 0x34 0x00 0xe9 0xff 0xcb 0xff 0xee 0xff 0xbb 0xff 0xc7 0xff 0x05 0x00 0x28 0x00 0x08 0x00 0x22 0x00 0x24 0x00 0x1b 0x00 0x19 0x00 0x2a 0x00 
0xe3 0xff 0x28 0x00 0x03 0x00 0xf2 0xff 0xeb 0xff 0xd2 0xff 0x0e 0x00 0xc0 0xff 0xe1 0xff 0x1a 0x00 0xf9 0xff 0xe0 0xff 0x16 0x00 0x01 0x00 0x19 0x00 0x3c 0x00 
0xd7 0xff 0x28 0x00 0xe5 0xff 0xe9 0xff 0xc8 0xff 0xb8 0xff 0xff 0xff 0xf4 0xff 0xe1 0xff 0xf2 0xff 0xf9 0xff 0xbb 0xff 0x0e 0x00 0x01 0x00 0xe3 0xff 0x21 0x00 
0xd6 0xff 0x28 0x00 0xcf 0xff 0xfe 0xff 0xeb 0xff 0xb4 0xff 0xe8 0xff 0x05 0x00 0xe6 0xff 0xdc 0xff 0x22 0x00 0xd3 0xff 0xda 0xff 0x01 0x00 0xe3 0xff 0x21 0x00 
0xe4 0xff 0x2a 0x00 0xbd 0xff 0x0c 0x00 0xe3 0xff 0xfc 0xff 0xf9 0xff 0x05 0x00 0xce 0xff 0x11 0x00 0x34 0x00 0xd3 0xff 0xcf 0xff 0x2c 0x00 0xe3 0xff 0x0d 0x00 
0x4a 0x00 0x15 0x00 0xbd 0xff 0x18 0x00 0xee 0xff 0x28 0x00 0xf9 0xff 0x05 0x00 0xce 0xff 0x1c 0x00 0x40 0x00 0xd3 0xff 0xcc 0xff 0x2c 0x00 0x10 0x00 0x29 0x00 
0xe3 0xff 0xe0 0xff 0x33 0x00 0xe6 0xff 0xe9 0xff 0x20 0x00 0xbb 0xff 0x3e 0x00 0xec 0xff 0xea 0xff 0xec 0xff 0x22 0x00 0x0e 0x00 0x19 0x00 0x19 0x00 0x57 0x00 
0xf7 0xff 0x27 0x00 0xf1 0xff 0xe9 0xff 0xf0 0xff 0x20 0x00 0xc9 0xff 0x09 0x00 0xe6 0xff 0xd3 0xff 0xf9 0xff 0x0e 0x00 0x0d 0x00 0xf2 0xff 0x19 0x00 0x63 0x00 
0xf7 0xff 0x18 0x00 0xe5 0xff 0xfe 0xff 0xd9 0xff 0x1c 0x00 0xff 0xff 0x09 0x00 0x21 0x00 0xc5 0xff 0xe7 0xff 0xbb 0xff 0x0d 0x00 0xe6 0xff 0x0e 0x00 0x1b 0x00 
0xf7 0xff 0x28 0x00 0xe2 0xff 0x0f 0x00 0xeb 0xff 0xc9 0xff 0x03 0x00 0x1c 0x00 0x30 0x00 0xdc 0xff 0x13 0x00 0xbb 0xff 0xcf 0xff 0xe6 0xff 0x0e 0x00 0xfc 0xff 
0x2b 0x00 0x18 0x00 0xd8 0xff 0x33 0x00 0xe0 0xff 0xb4 0xff 0xff 0xff 0x10 0x00 0x30 0x00 0x2b 0x00 0x22 0x00 0xbe 0xff 0xd4 0xff 0x42 0x00 0x0e 0x00 0x0d 0x00 
0x39 0x00 0x0e 0x00 0xe2 0xff 0x0c 0x00 0xe0 0xff 0xf7 0xff 0xdf 0xff 0x10 0x00 0xf1 0xff 0x2b 0x00 0x40 0x00 0xd2 0xff 0x2f 0x00 0x19 0x00 0xd9 0xff 0x2d 0x00 
0xd7 0xff 0x13 0x00 0x39 0x00 0xe6 0xff 0x0c 0x00 0x20 0x00 0xd4 0xff 0x3e 0x00 0xe6 0xff 0xe1 0xff 0xec 0xff 0x17 0x00 0x0e 0x00 0x1a 0x00 0x1c 0x00 0xfb 0xff 
0xf7 0xff 0x27 0x00 0xea 0xff 0xf6 0xff 0xfe 0xff 0x1c 0x00 0x02 0x00 0x09 0x00 0x17 0x00 0xc5 0xff 0xfd 0xff 0x17 0x00 0xde 0xff 0xf2 0xff 0x29 0x00 0x57 0x00 
0x13 0x00 0x18 0x00 0xce 0xff 0x0d 0x00 0xf0 0xff 0x1c 0x00 0x25 0x00 0x1c 0x00 0x28 0x00 0xc5 0xff 0xe7 0xff 0xd8 0xff 0xab 0xff 0x1a 0x00 0x1f 0x00 0x1b 0x00 
0x1a 0x00 0x18 0x00 0xcf 0xff 0x17 0x00 0xfc 0xff 0xf7 0xff 0x25 0x00 0x2a 0x00 0x30 0x00 0x07 0x00 0x13 0x00 0xd3 0xff 0xcf 0xff 0xcd 0xff 0x1f 0x00 0xd1 0xff 
0x2b 0x00 0x0e 0x00 0xe2 0xff 0x3d 0x00 0xeb 0xff 0xf7 0xff 0x13 0x00 0x2a 0x00 0x21 0x00 0x2b 0x00 0x13 0x00 0xd3 0xff 0xd7 0xff 0x42 0x00 0x1f 0x00 0xcd 0xff 
0x37 0x00 0xfb 0xff 0xe2 0xff 0x33 0x00 0xeb 0xff 0xf7 0xff 0xd8 0xff 0x10 0x00 0xf1 0xff 0x1c 0x00 0x13 0x00 0xd3 0xff 0xd7 0xff 0xdf 0xff 0x23 0x00 0x26 0x00 
0xb4 0xff 0x37 0x00 0x39 0x00 0xdf 0xff 0xdb 0xff 0x22 0x00 0xdc 0xff 0x08 0x00 0xe6 0xff 0xe1 0xff 0xd7 0xff 0x0e 0x00 0xde 0xff 0x19 0x00 0x24 0x00 0xe1 0xff 
0xe4 0xff 0x31 0x00 0xf7 0xff 0xf6 0xff 0xf0 0xff 0x20 0x00 0xdc 0xff 0xf3 0xff 0x17 0x00 0xc5 0xff 0xe4 0xff 0x17 0x00 0xca 0xff 0x19 0x00 0x2e 0x00 0xec 0xff 
0x13 0x00 0x37 0x00 0xea 0xff 0x02 0x00 0xf0 0xff 0x22 0x00 0xdc 0xff 0x05 0x00 0x21 0x00 0xc5 0xff 0xe4 0xff 0x04 0x00 0xab 0xff 0x1a 0x00 0x1f 0x00 0xd1 0xff 
0x37 0x00 0x2c 0x00 0xe2 0xff 0x0d 0x00 0xf0 0xff 0xf8 0xff 0x18 0x00 0x2a 0x00 0x21 0x00 0x07 0x00 0x29 0x00 0xfb 0xff 0xa0 0xff 0xce 0xff 0x0d 0x00 0xb9 0xff 
0x37 0x00 0x02 0x00 0xe2 0xff 0x2e 0x00 0xe6 0xff 0x21 0x00 0xf5 0xff 0x34 0x00 0x1a 0x00 0x2b 0x00 0x07 0x00 0x04 0x00 0xd4 0xff 0x19 0x00 0x0d 0x00 0xb4 0xff 
0x37 0x00 0xd2 0xff 0xe2 0xff 0x22 0x00 0xd0 0xff 0xf8 0xff 0xf4 0xff 0x11 0x00 0xd6 0xff 0x07 0x00 0xdd 0xff 0x1c 0x00 0xd4 0xff 0xea 0xff 0xc9 0xff 0xcd 0xff 
0xfa 0xff 0x49 0x00 0x25 0x00 0x05 0x00 0x2f 0x00 0x22 0x00 0xf6 0xff 0xe0 0xff 0xb9 0xff 0xf7 0xff 0xfd 0xff 0x0e 0x00 0xe5 0xff 0xea 0xff 0x1c 0x00 0xe1 0xff 
0xed 0xff 0x37 0x00 0x25 0x00 0x02 0x00 0x2f 0x00 0x22 0x00 0xf6 0xff 0xe0 0xff 0xb7 0xff 0xe6 0xff 0xfd 0xff 0x0e 0x00 0xde 0xff 0xfd 0xff 0x24 0x00 0xec 0xff 
0x45 0x00 0x5a 0x00 0x3c 0x00 0x0d 0x00 0x15 0x00 0x24 0x00 0xdc 0xff 0x1b 0x00 0x16 0x00 0xf0 0xff 0x16 0x00 0x0e 0x00 0xe5 0xff 0xec 0xff 0x11 0x00 0xe1 0xff 
0x45 0x00 0x54 0x00 0xf7 0xff 0x2e 0x00 0x12 0x00 0xf8 0xff 0xf5 0xff 0x2a 0x00 0x21 0x00 0x16 0x00 0x29 0x00 0x18 0x00 0x05 0x00 0xce 0xff 0xf2 0xff 0xc7 0xff 
0xf8 0xff 0xd2 0xff 0xe9 0xff 0x2e 0x00 0x09 0x00 0xf8 0xff 0xf5 0xff 0x2a 0x00 0x16 0x00 0x16 0x00 0x29 0x00 0x18 0x00 0xd7 0xff 0xce 0xff 0xe5 0xff 0xb9 0xff 
0xcc 0xff 0xce 0xff 0xcf 0xff 0x22 0x00 0xeb 0xff 0x17 0x00 0xfe 0xff 0xff 0xff 0xd6 0xff 0x07 0x00 0xef 0xff 0x1c 0x00 0xc5 0xff 0xcd 0xff 0xc6 0xff 0xcd 0xff 
0x16 0x00 0xb5 0xff 0x06 0x00 0xf7 0xff 0x07 0x00 0x16 0x00 0xdf 0xff 0xf4 0xff 0xf9 0xff 0xd3 0xff 0xff 0xff 0xcd 0xff 0x1b 0x00 0x3b 0x00 0x03 0x00 0x1a 0x00 
0x13 0x00 0xeb 0xff 0x06 0x00 0xe6 0xff 0x03 0x00 0xf0 0xff 0xdf 0xff 0xf7 0xff 0x3b 0x00 0xbe 0xff 0xff 0xff 0xe3 0xff 0x21 0x00 0x02 0x00 0x03 0x00 0x1a 0x00 
0xfc 0xff 0xea 0xff 0xe8 0xff 0xf6 0xff 0xf0 0xff 0xcd 0xff 0xd7 0xff 0xd3 0xff 0x3b 0x00 0xd3 0xff 0x12 0x00 0xfc 0xff 0x16 0x00 0x02 0x00 0x25 0x00 0x3b 0x00 
0xd6 0xff 0xff 0xff 0xd7 0xff 0x06 0x00 0xef 0xff 0xea 0xff 0xe9 0xff 0xd3 0xff 0x48 0x00 0x30 0x00 0xf7 0xff 0xfc 0xff 0xe6 0xff 0xc1 0xff 0x40 0x00 0x33 0x00 
0xd6 0xff 0xff 0xff 0xf0 0xff 0x27 0x00 0xf0 0xff 0x33 0x00 0xc2 0xff 0xd3 0xff 0x36 0x00 0x27 0x00 0x53 0x00 0xe6 0xff 0xe2 0xff 0xc1 0xff 0x1a 0x00 0x02 0x00 
0xd6 0xff 0x13 0x00 0xf0 0xff 0x06 0x00 0x39 0x00 0x37 0x00 0xcf 0xff 0xff 0xff 0x18 0x00 0x5a 0x00 0x37 0x00 0xc7 0xff 0xec 0xff 0xe5 0xff 0x1a 0x00 0xdd 0xff 
0x14 0x00 0xeb 0xff 0xc8 0xff 0xfb 0xff 0x13 0x00 0x21 0x00 0xd5 0xff 0xf3 0xff 0xef 0xff 0xfc 0xff 0xf8 0xff 0xd4 0xff 0x16 0x00 0x08 0x00 0xe7 0xff 0x1a 0x00 
0xfc 0xff 0x03 0x00 0xf6 0xff 0xf6 0xff 0x07 0x00 0x40 0x00 0xd5 0xff 0xf7 0xff 0xf9 0xff 0xbe 0xff 0xf7 0xff 0xe3 0xff 0x16 0x00 0x08 0x00 0xf4 0xff 0x09 0x00 
0xfc 0xff 0xff 0xff 0xd7 0xff 0xe6 0xff 0x03 0x00 0x01 0x00 0xb3 0xff 0xf7 0xff 0x32 0x00 0xbe 0xff 0x12 0x00 0xfd 0xff 0xe8 0xff 0x1e 0x00 0x0a 0x00 0x33 0x00 
0xeb 0xff 0xff 0xff 0xd7 0xff 0xf6 0xff 0x03 0x00 0x33 0x00 0xb6 0xff 0xd3 0xff 0x3b 0x00 0xfd 0xff 0xf7 0xff 0x07 0x00 0xe8 0xff 0xdf 0xff 0x0a 0x00 0x09 0x00 
0xd6 0xff 0x02 0x00 0xf0 0xff 0x27 0x00 0x16 0x00 0x36 0x00 0xc2 0xff 0xd3 0xff 0x25 0x00 0x27 0x00 0x18 0x00 0x07 0x00 0xec 0xff 0xdf 0xff 0xfc 0xff 0x02 0x00 
0xd6 0xff 0x26 0x00 0xf0 0xff 0x18 0x00 0x3c 0x00 0x33 0x00 0x07 0x00 0xda 0xff 0xf5 0xff 0x44 0x00 0xf7 0xff 0xec 0xff 0x1b 0x00 0xfd 0xff 0xfc 0xff 0x02 0x00 
0x13 0x00 0x0a 0x00 0x04 0x00 0xfb 0xff 0x13 0x00 0x0c 0x00 0x2c 0x00 0x0f 0x00 0xef 0xff 0x43 0x00 0xf8 0xff 0xd7 0xff 0xd4 0xff 0x08 0x00 0xe7 0xff 0xdb 0xff 
0x08 0x00 0xdf 0xff 0x04 0x00 0xf9 0xff 0x13 0x00 0x07 0x00 0x0b 0x00 0x16 0x00 0xf9 0xff 0x3b 0x00 0x15 0x00 0xe3 0xff 0x16 0x00 0x1e 0x00 0x0a 0x00 0xdb 0xff 
0x02 0x00 0xda 0xff 0x04 0x00 0xf6 0xff 0x40 0x00 0x07 0x00 0x01 0x00 0x0e 0x00 0xfd 0xff 0x27 0x00 0x15 0x00 0xfd 0xff 0x21 0x00 0x49 0x00 0x15 0x00 0x4b 0x00 
0xfc 0xff 0xe2 0xff 0x2a 0x00 0xf9 0xff 0x55 0x00 0x0b 0x00 0x01 0x00 0xd5 0xff 0x17 0x00 0x31 0x00 0xf7 0xff 0xfb 0xff 0x21 0x00 0x2c 0x00 0x0a 0x00 0x1f 0x00 
0xe1 0xff 0x02 0x00 0x1f 0x00 0x3c 0x00 0x33 0x00 0x36 0x00 0x17 0x00 0xd5 0xff 0xfd 0xff 0x31 0x00 0x10 0x00 0xfb 0xff 0x1b 0x00 0xfd 0xff 0xdf 0xff 0x1f 0x00 
0xeb 0xff 0x32 0x00 0x1f 0x00 0x39 0x00 0x33 0x00 0x0b 0x00 0x07 0x00 0x01 0x00 0xf5 0xff 0x40 0x00 0xfd 0xff 0xec 0xff 0x1b 0x00 0xfd 0xff 0xdf 0xff 0x1f 0x00 
0x2e 0x00 0x21 0x00 0x44 0x00 0xfb 0xff 0x04 0x00 0x02 0x00 0x2f 0x00 0x0f 0x00 0xef 0xff 0x12 0x00 0x30 0x00 0xcf 0xff 0xcc 0xff 0xed 0xff 0xfb 0xff 0xcf 0xff 
0xb2 0xff 0x01 0x00 0x04 0x00 0x16 0x00 0x13 0x00 0x02 0x00 0x2c 0x00 0x0e 0x00 0xf8 0xff 0x21 0x00 0x3b 0x00 0xcf 0xff 0xd4 0xff 0x08 0x00 0x15 0x00 0xdb 0xff 
0x06 0x00 0xe2 0xff 0x2a 0x00 0x16 0x00 0x13 0x00 0x07 0x00 0x06 0x00 0x0e 0x00 0xfd 0xff 0x27 0x00 0x15 0x00 0xfd 0xff 0x30 0x00 0x2c 0x00 0xff 0xff 0x0e 0x00 
0xeb 0xff 0xe5 0xff 0x38 0x00 0x16 0x00 0x33 0x00 0x0b 0x00 0x06 0x00 0xd5 0xff 0xfd 0xff 0x28 0x00 0xe7 0xff 0xfb 0xff 0xf7 0xff 0x05 0x00 0xdd 0xff 0x4b 0x00 
0xe8 0xff 0xe5 0xff 0x38 0x00 0x3c 0x00 0xfb 0xff 0x36 0x00 0x39 0x00 0xd5 0xff 0xd2 0xff 0x28 0x00 0xfd 0xff 0xff 0xff 0xf7 0xff 0xdf 0xff 0xdd 0xff 0x1f 0x00 
0xe8 0xff 0x32 0x00 0xe6 0xff 0x2a 0x00 0x16 0x00 0x0b 0x00 0x17 0x00 0xd6 0xff 0xd2 0xff 0x31 0x00 0xfd 0xff 0xfb 0xff 0xe2 0xff 0xfd 0xff 0xdd 0xff 0x1f 0x00 
0x43 0x00 0x17 0x00 0x52 0x00 0x22 0x00 0xe8 0xff 0xed 0xff 0x3d 0x00 0x17 0x00 0xc9 0xff 0x12 0x00 0x30 0x00 0xb4 0xff 0xcc 0xff 0xed 0xff 0x06 0x00 0xcd 0xff 
0x1c 0x00 0xf9 0xff 0x32 0x00 0x16 0x00 0x04 0x00 0x02 0x00 0x2f 0x00 0x02 0x00 0xf8 0xff 0xd4 0xff 0x3b 0x00 0xcf 0xff 0xbf 0xff 0x0e 0x00 0x3b 0x00 0x0e 0x00 
0x1c 0x00 0xe3 0xff 0x32 0x00 0x2d 0x00 0x04 0x00 0x07 0x00 0x06 0x00 0xe8 0xff 0xc5 0xff 0x21 0x00 0x0a 0x00 0xff 0xff 0x1e 0x00 0xde 0xff 0x3b 0x00 0x4b 0x00 
0x08 0x00 0xe5 0xff 0x42 0x00 0x37 0x00 0xd0 0xff 0x0b 0x00 0x0b 0x00 0xd5 0xff 0xc5 0xff 0x28 0x00 0xd7 0xff 0xb1 0xff 0xc7 0xff 0xdf 0xff 0x08 0x00 0x4b 0x00 
0x06 0x00 0xe5 0xff 0x42 0x00 0x37 0x00 0xd0 0xff 0x0b 0x00 0x15 0x00 0xd6 0xff 0xad 0xff 0x22 0x00 0xdf 0xff 0xf4 0xff 0xc7 0xff 0xdf 0xff 0xdf 0xff 0x31 0x00 
0x15 0x00 0xe7 0xff 0xc0 0xff 0x2a 0x00 0xfb 0xff 0x16 0x00 0x15 0x00 0xd5 0xff 0xce 0xff 0x0e 0x00 0x17 0x00 0xeb 0xff 0xc7 0xff 0x05 0x00 0xdf 0xff 0x21 0x00 
0x0b 0x00 0x17 0x00 0x41 0x00 0x21 0x00 0xc4 0xff 0x25 0x00 0x22 0x00 0x17 0x00 0xc9 0xff 0xe3 0xff 0x30 0x00 0xb9 0xff 0x13 0x00 0x0e 0x00 0xfb 0xff 0xcf 0xff 
0x1c 0x00 0x01 0x00 0x13 0x00 0x16 0x00 0xcb 0xff 0x13 0x00 0xf8 0xff 0xd2 0xff 0xc9 0xff 0xcc 0xff 0x3b 0x00 0xed 0xff 0x0a 0x00 0x0e 0x00 0x3b 0x00 0x0e 0x00 
0x35 0x00 0x17 0x00 0x13 0x00 0x22 0x00 0xcb 0xff 0x13 0x00 0x06 0x00 0xd2 0xff 0xfe 0xff 0x1b 0x00 0x0a 0x00 0xff 0xff 0x0a 0x00 0xde 0xff 0x3b 0x00 0x3b 0x00 
0x35 0x00 0xf7 0xff 0xfe 0xff 0x16 0x00 0xcb 0xff 0x41 0x00 0x06 0x00 0xd2 0xff 0xc5 0xff 0x21 0x00 0xc6 0xff 0xe6 0xff 0xc7 0xff 0xdf 0xff 0x08 0x00 0x3b 0x00 
0x35 0x00 0xf7 0xff 0xfe 0xff 0x06 0x00 0xd0 0xff 0x16 0x00 0x12 0x00 0xd6 0xff 0xf6 0xff 0x1e 0x00 0xd7 0xff 0xf4 0xff 0xc9 0xff 0xf4 0xff 0xce 0xff 0x35 0x00 
0x43 0x00 0xf7 0xff 0xc0 0xff 0x2a 0x00 0xfb 0xff 0x16 0x00 0x12 0x00 0xcc 0xff 0xad 0xff 0x0e 0x00 0x48 0x00 0xe6 0xff 0xc9 0xff 0x20 0x00 0xce 0xff 0x31 0x00 
0x21 0x00 0xef 0xff 0x0f 0x00 0xd9 0xff 0xc4 0xff 0x33 0x00 0x49 0x00 0xf7 0xff 0x0f 0x00 0x1b 0x00 0xe7 0xff 0x01 0x00 0xfb 0xff 0x18 0x00 0x38 0x00 0x11 0x00 
0x19 0x00 0x07 0x00 0x9d 0xff 0xdf 0xff 0x0a 0x00 0x33 0x00 0x03 0x00 0x43 0x00 0x35 0x00 0x32 0x00 0x21 0x00 0x01 0x00 0xfd 0xff 0x41 0x00 0x21 0x00 0xc3 0xff 
0x1d 0x00 0x4c 0x00 0x9d 0xff 0xdf 0xff 0x0a 0x00 0xd5 0xff 0x4c 0x00 0x43 0x00 0x35 0x00 0x32 0x00 0x24 0x00 0x02 0x00 0x6f 0x00 0x42 0x00 0x0e 0x00 0xe3 0xff 
0x39 0x00 0x4c 0x00 0xd2 0xff 0x17 0x00 0x0a 0x00 0x07 0x00 0x06 0x00 0x2d 0x00 0x34 0x00 0xe3 0xff 0x24 0x00 0x33 0x00 0x03 0x00 0x3d 0x00 0xfa 0xff 0xe3 0xff 
0x1d 0x00 0xf4 0xff 0xf3 0xff 0xea 0xff 0x12 0x00 0x07 0x00 0x14 0x00 0x29 0x00 0x0e 0x00 0xe3 0xff 0x24 0x00 0x37 0x00 0x03 0x00 0x2a 0x00 0xce 0xff 0xe3 0xff 
0xeb 0xff 0xf4 0xff 0xf2 0xff 0x17 0x00 0x46 0x00 0x07 0x00 0x05 0x00 0x1a 0x00 0xec 0xff 0xf5 0xff 0x38 0x00 0x24 0x00 0x36 0x00 0x12 0x00 0xce 0xff 0x08 0x00 
0x19 0x00 0xfd 0xff 0x4d 0x00 0xd0 0xff 0xc4 0xff 0xd5 0xff 0x46 0x00 0x26 0x00 0xf8 0xff 0x16 0x00 0xdf 0xff 0xc6 0xff 0xfd 0xff 0x18 0x00 0x3a 0x00 0xfd 0xff 
0x21 0x00 0xfd 0xff 0xf9 0xff 0xd9 0xff 0x13 0x00 0x1f 0x00 0x06 0x00 0xf7 0xff 0x35 0x00 0xf1 0xff 0xea 0xff 0x01 0x00 0x52 0x00 0x3a 0x00 0x38 0x00 0xfc 0xff 
0x39 0x00 0x4c 0x00 0x0f 0x00 0xdf 0xff 0x2a 0x00 0x1b 0x00 0x0a 0x00 0x29 0x00 0x46 0x00 0xe9 0xff 0xea 0xff 0x02 0x00 0x6f 0x00 0x3a 0x00 0x16 0x00 0xfd 0xff 
0x3d 0x00 0x06 0x00 0x02 0x00 0x2c 0x00 0xe6 0xff 0x1f 0x00 0x03 0x00 0x1a 0x00 0x34 0x00 0xe3 0xff 0x38 0x00 0x33 0x00 0x6a 0x00 0x12 0x00 0xd7 0xff 0xfc 0xff 
0x1a 0x00 0xf4 0xff 0x02 0x00 0x17 0x00 0xe6 0xff 0x1b 0x00 0xea 0xff 0x20 0x00 0x1d 0x00 0xdb 0xff 0xf0 0xff 0x34 0x00 0x51 0x00 0x12 0x00 0xce 0xff 0x11 0x00 
0xff 0xff 0xf4 0xff 0xd4 0xff 0xdc 0xff 0x46 0x00 0x07 0x00 0xe9 0xff 0x1a 0x00 0xec 0xff 0x08 0x00 0x38 0x00 0x33 0x00 0x36 0x00 0x12 0x00 0xce 0xff 0x08 0x00 
0x19 0x00 0x11 0x00 0x49 0x00 0xd9 0xff 0xbc 0xff 0xf0 0xff 0x10 0x00 0xfc 0xff 0xf2 0xff 0xf8 0xff 0xe1 0xff 0x01 0x00 0xe0 0xff 0xe5 0xff 0x34 0x00 0xfa 0xff 
0x19 0x00 0xe9 0xff 0x49 0x00 0xd9 0xff 0xec 0xff 0xf0 0xff 0xcf 0xff 0xc1 0xff 0xf8 0xff 0xe9 0xff 0x36 0x00 0x25 0x00 0xfd 0xff 0xe5 0xff 0x16 0x00 0xfc 0xff 
0x19 0x00 0x06 0x00 0x17 0x00 0xdf 0xff 0x2a 0x00 0x1f 0x00 0x06 0x00 0xfc 0xff 0x34 0x00 0xde 0xff 0x36 0x00 0x25 0x00 0x52 0x00 0x3a 0x00 0x0e 0x00 0xfd 0xff 
0x1a 0x00 0xdd 0xff 0x13 0x00 0x23 0x00 0x33 0x00 0x1b 0x00 0x06 0x00 0xb2 0xff 0x23 0x00 0xe3 0xff 0xef 0xff 0x32 0x00 0x56 0x00 0x32 0x00 0xcb 0xff 0xa0 0xff 
0xf6 0xff 0x06 0x00 0x09 0x00 0xdc 0xff 0xb3 0xff 0x1b 0x00 0x19 0x00 0x20 0x00 0xec 0xff 0xd4 0xff 0xef 0xff 0x33 0x00 0x13 0x00 0x32 0x00 0xd7 0xff 0xa0 0xff 
0xf6 0xff 0xce 0xff 0x09 0x00 0xdc 0xff 0xf2 0xff 0xdd 0xff 0xf2 0xff 0xc0 0xff 0xb1 0xff 0xed 0xff 0xef 0xff 0x33 0x00 0xf5 0xff 0x32 0x00 0xd3 0xff 0xa0 0xff 
0xda 0xff 0xf2 0xff 0xf9 0xff 0xd9 0xff 0xec 0xff 0xf0 0xff 0x01 0x00 0xfc 0xff 0xf2 0xff 0xb7 0xff 0x14 0x00 0xdf 0xff 0xd9 0xff 0xe5 0xff 0x34 0x00 0xe0 0xff 
0xd1 0xff 0xe9 0xff 0x17 0x00 0xd9 0xff 0xec 0xff 0x04 0x00 0xcc 0xff 0xc1 0xff 0xf2 0xff 0xe9 0xff 0x36 0x00 0xe7 0xff 0xd9 0xff 0xe5 0xff 0x34 0x00 0xe0 0xff 
0xd1 0xff 0xf2 0xff 0x1d 0x00 0x23 0x00 0xbc 0xff 0x1f 0x00 0xcf 0xff 0xfc 0xff 0x23 0x00 0xc2 0xff 0x36 0x00 0x14 0x00 0x4f 0x00 0x22 0x00 0x34 0x00 0xc1 0xff 
0xfe 0xff 0xdd 0xff 0x31 0x00 0xdc 0xff 0xce 0xff 0x0c 0x00 0xe9 0xff 0x03 0x00 0x1d 0x00 0xc2 0xff 0x1b 0x00 0x2b 0x00 0x44 0x00 0x3a 0x00 0xe3 0xff 0xa0 0xff 
0xf6 0xff 0x16 0x00 0x1d 0x00 0x02 0x00 0xb3 0xff 0x1f 0x00 0xea 0xff 0x03 0x00 0xfa 0xff 0xb8 0xff 0xeb 0xff 0x34 0x00 0x13 0x00 0x32 0x00 0xe3 0xff 0xa0 0xff 
0xf8 0xff 0xce 0xff 0x37 0x00 0xdc 0xff 0xde 0xff 0xe9 0xff 0xf2 0xff 0xc0 0xff 0xfa 0xff 0xed 0xff 0xea 0xff 0x34 0x00 0xdb 0xff 0x32 0x00 0xd3 0xff 0xce 0xff 
0xcd 0xff 0xf2 0xff 0xee 0xff 0x27 0x00 0xec 0xff 0x04 0x00 0xcf 0xff 0xe6 0xff 0xf1 0xff 0xb7 0xff 0x14 0x00 0x42 0x00 0xd6 0xff 0xe0 0xff 0x44 0x00 0xfa 0xff 
0xd1 0xff 0xf2 0xff 0x31 0x00 0x0d 0x00 0xdf 0xff 0x04 0x00 0xcc 0xff 0xfc 0xff 0xf2 0xff 0xfc 0xff 0x15 0x00 0x44 0x00 0xd6 0xff 0xd4 0xff 0x37 0x00 0xe0 0xff 
0xcc 0xff 0x14 0x00 0x1d 0x00 0x46 0x00 0xce 0xff 0x1b 0x00 0x35 0x00 0xfc 0xff 0xca 0xff 0xf8 0xff 0x1b 0x00 0x14 0x00 0xf1 0xff 0xd4 0xff 0x37 0x00 0xb8 0xff 
0xf6 0xff 0x3c 0x00 0x1d 0x00 0xdc 0xff 0xdf 0xff 0xd2 0xff 0x35 0x00 0x03 0x00 0xfa 0xff 0xee 0xff 0xed 0xff 0x14 0x00 0x44 0x00 0x3c 0x00 0x16 0x00 0xa6 0xff 
0xf6 0xff 0x49 0x00 0x0a 0x00 0x23 0x00 0xe9 0xff 0xf8 0xff 0x35 0x00 0xa9 0xff 0xe0 0xff 0xc5 0xff 0xed 0xff 0x08 0x00 0xe2 0xff 0x22 0x00 0x16 0x00 0xb8 0xff 
0xf9 0xff 0x3c 0x00 0x31 0x00 0x1b 0x00 0xde 0xff 0xe9 0xff 0xf4 0xff 0xc0 0xff 0xe0 0xff 0xed 0xff 0xea 0xff 0xf0 0xff 0xdb 0xff 0x32 0x00 0xe3 0xff 0x12 0x00 
0xad 0xff 0x17 0x00 0xb4 0xff 0x0d 0x00 0xec 0xff 0x04 0x00 0xab 0xff 0xe6 0xff 0x1b 0x00 0xfc 0xff 0x15 0x00 0xe7 0xff 0xd2 0xff 0x14 0x00 0x64 0x00 0x2e 0x00 
0xb0 0xff 0x17 0x00 0xe1 0xff 0x09 0x00 0xce 0xff 0x04 0x00 0xcf 0xff 0xaa 0xff 0x2b 0x00 0x11 0x00 0x39 0x00 0x34 0x00 0xd2 0xff 0x14 0x00 0x64 0x00 0x1a 0x00 
0xcc 0xff 0x17 0x00 0x0a 0x00 0x1c 0x00 0xdf 0xff 0x0c 0x00 0x4d 0x00 0xaa 0xff 0xd7 0xff 0xf8 0xff 0x1b 0x00 0xed 0xff 0xcb 0xff 0x0b 0x00 0x37 0x00 0xc1 0xff 
0xf9 0xff 0x44 0x00 0x1d 0x00 0xaf 0xff 0xdf 0xff 0xf6 0xff 0x4d 0x00 0xe2 0xff 0xfa 0xff 0xf8 0xff 0xf4 0xff 0x08 0x00 0xcb 0xff 0x22 0x00 0x27 0x00 0xc1 0xff 
0xf4 0xff 0x45 0x00 0x0a 0x00 0x02 0x00 0x37 0x00 0xf8 0xff 0x4b 0x00 0xdb 0xff 0xe0 0xff 0xe6 0xff 0xed 0xff 0xf0 0xff 0xe2 0xff 0x0b 0x00 0x16 0x00 0xfc 0xff 
0xf8 0xff 0x3c 0x00 0x01 0x00 0x1b 0x00 0xd2 0xff 0xf1 0xff 0xf5 0xff 0x03 0x00 0x12 0x00 0xe6 0xff 0xe4 0xff 0xf0 0xff 0xd7 0xff 0x16 0x00 0xe3 0xff 0x12 0x00 
0x1f 0x00 0xdb 0xff 0x19 0x00 0x0f 0x00 0x50 0x00 0xf3 0xff 0x07 0x00 0xd9 0xff 0x10 0x00 0x08 0x00 0x01 0x00 0x1b 0x00 0x06 0x00 0x24 0x00 0x0b 0x00 0x51 0x00 
0x1f 0x00 0xdb 0xff 0xfa 0xff 0xed 0xff 0x03 0x00 0xf3 0xff 0x44 0x00 0xd9 0xff 0xe6 0xff 0x08 0x00 0xce 0xff 0xc8 0xff 0xf3 0xff 0x16 0x00 0x42 0x00 0x2b 0x00 
0x14 0x00 0x2f 0x00 0xa5 0xff 0xed 0xff 0x03 0x00 0x10 0x00 0x0b 0x00 0xca 0xff 0x93 0xff 0x01 0x00 0xff 0xff 0xc8 0xff 0xdf 0xff 0xf6 0xff 0x44 0x00 0xe9 0xff 
0xfb 0xff 0x2f 0x00 0xbf 0xff 0xed 0xff 0x24 0x00 0x10 0x00 0x09 0x00 0xd2 0xff 0xec 0xff 0x01 0x00 0xde 0xff 0xb5 0xff 0xdf 0xff 0x1a 0x00 0x11 0x00 0xe9 0xff 
0x29 0x00 0x2a 0x00 0x1f 0x00 0xf3 0xff 0x2d 0x00 0x0b 0x00 0xe4 0xff 0xf5 0xff 0x0c 0x00 0x01 0x00 0xde 0xff 0xcc 0xff 0x07 0x00 0x20 0x00 0x0c 0x00 0xd3 0xff 
0x29 0x00 0xd5 0xff 0x1f 0x00 0xfa 0xff 0x26 0x00 0xdc 0xff 0x09 0x00 0xf5 0xff 0x30 0x00 0x2c 0x00 0xe6 0xff 0xfa 0xff 0x07 0x00 0x2b 0x00 0x11 0x00 0xe2 0xff 
0x29 0x00 0xf5 0xff 0x05 0x00 0xfd 0xff 0x50 0x00 0xf3 0xff 0x07 0x00 0xc0 0xff 0xfa 0xff 0x23 0x00 0x01 0x00 0x2c 0x00 0x0f 0x00 0x16 0x00 0xca 0xff 0x2b 0x00 
0x2e 0x00 0xf5 0xff 0xfa 0xff 0xea 0xff 0x03 0x00 0xee 0xff 0x44 0x00 0xd1 0xff 0xd4 0xff 0x13 0x00 0xff 0xff 0x1d 0x00 0x0f 0x00 0x03 0x00 0x35 0x00 0xe6 0xff 
0x14 0x00 0x2f 0x00 0xd3 0xff 0xe1 0xff 0x2b 0x00 0x0b 0x00 0x44 0x00 0xca 0xff 0xd4 0xff 0x13 0x00 0xff 0xff 0x07 0x00 0xf9 0xff 0xf5 0xff 0x22 0x00 0xe6 0xff 
0x14 0x00 0xfc 0xff 0xd3 0xff 0xed 0xff 0x30 0x00 0x0b 0x00 0x44 0x00 0xd2 0xff 0x09 0x00 0x18 0x00 0xff 0xff 0xcc 0xff 0xdf 0xff 0x0a 0x00 0x02 0x00 0xe8 0xff 
0x18 0x00 0xfc 0xff 0x14 0x00 0x17 0x00 0x30 0x00 0x14 0x00 0x09 0x00 0xe7 0xff 0x0f 0x00 0x2c 0x00 0xff 0xff 0xe5 0xff 0xe4 0xff 0x1a 0x00 0xf4 0xff 0xe8 0xff 
0x29 0x00 0xd5 0xff 0x14 0x00 0x2b 0x00 0x29 0x00 0x14 0x00 0x09 0x00 0xe7 0xff 0x2a 0x00 0x44 0x00 0x0b 0x00 0xed 0xff 0xf4 0xff 0x1a 0x00 0xf4 0xff 0xe2 0xff 
0x04 0x00 0xf8 0xff 0x05 0x00 0xfd 0xff 0x33 0x00 0xf6 0xff 0xeb 0xff 0xd1 0xff 0x08 0x00 0x21 0x00 0x01 0x00 0x2c 0x00 0x06 0x00 0x17 0x00 0xb9 0xff 0x2c 0x00 
0x14 0x00 0xdb 0xff 0xfa 0xff 0xed 0xff 0x2b 0x00 0xee 0xff 0x42 0x00 0xc6 0xff 0xe6 0xff 0xed 0xff 0x24 0x00 0xd5 0xff 0xf9 0xff 0x0a 0x00 0xe8 0xff 0x2c 0x00 
0x14 0x00 0xdb 0xff 0xfa 0xff 0xed 0xff 0x2d 0x00 0xa3 0xff 0x28 0x00 0xca 0xff 0x09 0x00 0x12 0x00 0x24 0x00 0x07 0x00 0xf9 0xff 0xf5 0xff 0x22 0x00 0xe9 0xff 
0x18 0x00 0xf6 0xff 0xb5 0xff 0x1b 0x00 0x2d 0x00 0xe5 0xff 0x28 0x00 0xe7 0xff 0x0a 0x00 0x13 0x00 0x24 0x00 0xbc 0xff 0xf9 0xff 0xc5 0xff 0xe8 0xff 0xf8 0xff 
0x18 0x00 0xfc 0xff 0xeb 0xff 0x0a 0x00 0x29 0x00 0x21 0x00 0xba 0xff 0x07 0x00 0x0f 0x00 0x2c 0x00 0xff 0xff 0xe5 0xff 0xb5 0xff 0xc3 0xff 0xad 0xff 0xe9 0xff 
0x26 0x00 0xf6 0xff 0xe6 0xff 0x2e 0x00 0xfe 0xff 0x30 0x00 0xa1 0xff 0x20 0x00 0x2a 0x00 0x32 0x00 0x0e 0x00 0xed 0xff 0xe6 0xff 0x10 0x00 0xaf 0xff 0xe2 0xff 
0x04 0x00 0x30 0x00 0x2e 0x00 0x05 0x00 0x0c 0x00 0x1a 0x00 0xda 0xff 0xdb 0xff 0xdf 0xff 0x21 0x00 0x26 0x00 0x2c 0x00 0x06 0x00 0x03 0x00 0x9b 0xff 0x01 0x00 
0xec 0xff 0xf8 0xff 0x2e 0x00 0x1d 0x00 0x1e 0x00 0x1a 0x00 0x0e 0x00 0xe4 0xff 0x09 0x00 0xd8 0xff 0x28 0x00 0x07 0x00 0x0f 0x00 0xe2 0xff 0xb8 0xff 0x01 0x00 
0xec 0xff 0xe6 0xff 0x2e 0x00 0x1d 0x00 0x0c 0x00 0x07 0x00 0x28 0x00 0xed 0xff 0x0e 0x00 0xd8 0xff 0x28 0x00 0x07 0x00 0xf9 0xff 0xe2 0xff 0xd4 0xff 0x01 0x00 
0x18 0x00 0xe6 0xff 0xb5 0xff 0x2e 0x00 0x2b 0x00 0x07 0x00 0x28 0x00 0xf4 0xff 0x0e 0x00 0xcf 0xff 0x2b 0x00 0xd6 0xff 0xf9 0xff 0x0a 0x00 0xe8 0xff 0x09 0x00 
0x18 0x00 0xea 0xff 0xd3 0xff 0x2e 0x00 0xbd 0xff 0x14 0x00 0xcc 0xff 0x07 0x00 0x0f 0x00 0x22 0x00 0xe1 0xff 0x0f 0x00 0xad 0xff 0xc6 0xff 0xd4 0xff 0x09 0x00 
0x09 0x00 0xf6 0xff 0xe6 0xff 0x46 0x00 0xbd 0xff 0x21 0x00 0xc1 0xff 0x1c 0x00 0x24 0x00 0xf4 0xff 0x0e 0x00 0xed 0xff 0xb5 0xff 0xc6 0xff 0x15 0x00 0x09 0x00 
0x04 0x00 0xf0 0xff 0x0e 0x00 0x20 0x00 0x0c 0x00 0x23 0x00 0xda 0xff 0x2c 0x00 0xdf 0xff 0xfb 0xff 0xd9 0xff 0xd9 0xff 0xd2 0xff 0x19 0x00 0xb8 0xff 0x2c 0x00 
0x02 0x00 0xf0 0xff 0x0e 0x00 0x30 0x00 0x1e 0x00 0x23 0x00 0x15 0x00 0x2c 0x00 0x0e 0x00 0xd8 0xff 0x26 0x00 0xd6 0xff 0x14 0x00 0x19 0x00 0xb8 0xff 0x01 0x00 
0x02 0x00 0xb1 0xff 0x0e 0x00 0x30 0x00 0x0c 0x00 0x12 0x00 0x15 0x00 0x0a 0x00 0x0e 0x00 0xd8 0xff 0xfa 0xff 0xd6 0xff 0x0e 0x00 0x30 0x00 0xd4 0xff 0xd9 0xff 
0x02 0x00 0xe6 0xff 0xd9 0xff 0x2e 0x00 0xb0 0xff 0x12 0x00 0x28 0x00 0x0a 0x00 0xfa 0xff 0xcf 0xff 0xfa 0xff 0x0f 0x00 0x0e 0x00 0x10 0x00 0xd4 0xff 0x01 0x00 
0xbf 0xff 0xf6 0xff 0xeb 0xff 0x1f 0x00 0xb0 0xff 0x11 0x00 0x12 0x00 0x1c 0x00 0xfa 0xff 0x31 0x00 0xe1 0xff 0x39 0x00 0xaa 0xff 0x10 0x00 0xd4 0xff 0x01 0x00 
0xcc 0xff 0xf6 0xff 0x1b 0x00 0x2e 0x00 0xbd 0xff 0x1c 0x00 0x26 0x00 0x28 0x00 0xd3 0xff 0xcf 0xff 0xe1 0xff 0x13 0x00 0xc1 0xff 0x10 0x00 0xde 0xff 0x01 0x00 
0x0f 0x00 0x30 0x00 0x0e 0x00 0x30 0x00 0xe3 0xff 0xe8 0xff 0xf0 0xff 0x23 0x00 0xd2 0xff 0xfb 0xff 0xb7 0xff 0x14 0x00 0xd2 0xff 0xe2 0xff 0xbb 0xff 0xef 0xff 
0x02 0x00 0x1e 0x00 0x0e 0x00 0x30 0x00 0xe3 0xff 0x23 0x00 0x10 0x00 0x2c 0x00 0xdf 0xff 0xfb 0xff 0xff 0xff 0xfb 0xff 0x14 0x00 0x19 0x00 0xbe 0xff 0xef 0xff 
0x0e 0x00 0x1e 0x00 0xd9 0xff 0x1f 0x00 0xff 0xff 0x12 0x00 0x15 0x00 0x33 0x00 0x29 0x00 0xfb 0xff 0xd4 0xff 0xfb 0xff 0x0e 0x00 0x19 0x00 0xf7 0xff 0xef 0xff 
0xbf 0xff 0xfc 0xff 0xe6 0xff 0x1f 0x00 0xff 0xff 0x12 0x00 0x30 0x00 0x56 0x00 0x0e 0x00 0xe9 0xff 0xff 0xff 0x0f 0x00 0xbe 0xff 0x10 0x00 0x09 0x00 0x01 0x00 
0xbd 0xff 0xfc 0xff 0x21 0x00 0x30 0x00 0xf0 0xff 0x07 0x00 0x12 0x00 0x31 0x00 0xe3 0xff 0xe9 0xff 0xec 0xff 0x13 0x00 0xbe 0xff 0xf7 0xff 0x15 0x00 0x0a 0x00 
0xbd 0xff 0x12 0x00 0x21 0x00 0x3f 0x00 0xf0 0xff 0x07 0x00 0x26 0x00 0x1c 0x00 0xd3 0xff 0xb8 0xff 0xd0 0xff 0xd8 0xff 0xd7 0xff 0x10 0x00 0x23 0x00 0x01 0x00 
