0x0e 0x00 0x5a 0x00 0x60 0x00 0xe2 0xff 0xfc 0xff 0xf0 0xff 0xf4 0xff 0x44 0x00 0x18 0x00 0x0a 0x00 0xfe 0xff 0xfa 0xff 0x10 0x00 0x12 0x00 0xc8 0xff 0xce 0xff 
0x0a 0x00 0x24 0x00 0x16 0x00 0xf8 0xff 0xe4 0xff 0xbc 0xff 0x44 0x00 0x2a 0x00 0x18 0x00 0x2e 0x00 0x06 0x00 0xe6 0xff 0xf8 0xff 0x12 0x00 0xc2 0xff 0xce 0xff 
0x16 0x00 0x1c 0x00 0x14 0x00 0xe8 0xff 0xe4 0xff 0xfa 0xff 0x34 0x00 0x2a 0x00 0xf8 0xff 0x36 0x00 0x04 0x00 0xe6 0xff 0xd6 0xff 0x12 0x00 0x04 0x00 0xcc 0xff 
0xfe 0xff 0xc2 0xff 0xf2 0xff 0xfe 0xff 0xd8 0xff 0x06 0x00 0x34 0x00 0x20 0x00 0xf8 0xff 0x2e 0x00 0x48 0x00 0x1c 0x00 0xfe 0xff 0x08 0x00 0x20 0x00 0xe2 0xff 
0x2c 0x00 0xd6 0xff 0x14 0x00 0xfe 0xff 0xd8 0xff 0x06 0x00 0x20 0x00 0x38 0x00 0xfa 0xff 0xce 0xff 0x48 0x00 0xfa 0xff 0xf0 0xff 0xfa 0xff 0x20 0x00 0xec 0xff 
0xba 0xff 0xda 0xff 0xf2 0xff 0xf2 0xff 0xf0 0xff 0x0e 0x00 0x20 0x00 0x38 0x00 0x20 0x00 0xd4 0xff 0x12 0x00 0xfa 0xff 0xfe 0xff 0xd4 0xff 0xfa 0xff 0xec 0xff 
0x4a 0x00 0x5a 0x00 0x5a 0x00 0xce 0xff 0x02 0x00 0xf2 0xff 0xe0 0xff 0x16 0x00 0x14 0x00 0xe2 0xff 0xfe 0xff 0x02 0x00 0x18 0x00 0x12 0x00 0x1a 0x00 0xce 0xff 
0x18 0x00 0x24 0x00 0x1c 0x00 0xf8 0xff 0x0a 0x00 0xf2 0xff 0xe0 0xff 0x20 0x00 0x2c 0x00 0xec 0xff 0x0c 0x00 0xe6 0xff 0xd6 0xff 0xfa 0xff 0x04 0x00 0xce 0xff 
0x18 0x00 0x1c 0x00 0x1c 0x00 0x20 0x00 0x18 0x00 0x32 0x00 0xf4 0xff 0x20 0x00 0x06 0x00 0xec 0xff 0x0c 0x00 0xe6 0xff 0xcc 0xff 0xfa 0xff 0x0c 0x00 0xde 0xff 
0xfe 0xff 0x1c 0x00 0x12 0x00 0x20 0x00 0xd0 0xff 0x06 0x00 0x0e 0x00 0x20 0x00 0x0e 0x00 0xb8 0xff 0x54 0x00 0x1c 0x00 0xd2 0xff 0xfa 0xff 0x20 0x00 0xde 0xff 
0xd4 0xff 0x26 0x00 0x14 0x00 0x36 0x00 0xd4 0xff 0xea 0xff 0x1a 0x00 0x38 0x00 0x0e 0x00 0xce 0xff 0x54 0x00 0xfa 0xff 0xd2 0xff 0x2a 0x00 0x20 0x00 0xf8 0xff 
0xcc 0xff 0x26 0x00 0x12 0x00 0x36 0x00 0xf0 0xff 0x06 0x00 0x36 0x00 0x3a 0x00 0x36 0x00 0xe8 0xff 0x12 0x00 0xfa 0xff 0xba 0xff 0xfa 0xff 0xfa 0xff 0x10 0x00 
0x4a 0x00 0x52 0x00 0x60 0x00 0x28 0x00 0xce 0xff 0xf2 0xff 0xe0 0xff 0x16 0x00 0x0a 0x00 0xe2 0xff 0x34 0x00 0x1a 0x00 0x18 0x00 0x0e 0x00 0x1a 0x00 0xee 0xff 
0x46 0x00 0xfa 0xff 0x60 0x00 0x28 0x00 0x0a 0x00 0xf8 0xff 0xd0 0xff 0x08 0x00 0x3c 0x00 0xe2 0xff 0x0c 0x00 0x1a 0x00 0xd6 0xff 0xfa 0xff 0xbc 0xff 0xb2 0xff 
0x0e 0x00 0x1c 0x00 0x54 0x00 0x28 0x00 0x0c 0x00 0x32 0x00 0xcc 0xff 0x20 0x00 0x0a 0x00 0xec 0xff 0x0c 0x00 0x12 0x00 0xba 0xff 0x0e 0x00 0xc8 0xff 0xee 0xff 
0xc4 0xff 0x1c 0x00 0x1c 0x00 0x20 0x00 0xd0 0xff 0x06 0x00 0x3a 0x00 0x20 0x00 0x3c 0x00 0xec 0xff 0x2c 0x00 0x12 0x00 0xbe 0xff 0xfa 0xff 0x04 0x00 0xcc 0xff 
0xd4 0xff 0x26 0x00 0x2c 0x00 0x36 0x00 0xd2 0xff 0xf0 0xff 0x5e 0x00 0x22 0x00 0x16 0x00 0xea 0xff 0x3a 0x00 0x10 0x00 0xce 0xff 0xfa 0xff 0x20 0x00 0xde 0xff 
0xd4 0xff 0x26 0x00 0x12 0x00 0x48 0x00 0xd8 0xff 0xe8 0xff 0x68 0x00 0x20 0x00 0x16 0x00 0xe8 0xff 0x12 0x00 0xfa 0xff 0xba 0xff 0xda 0xff 0xf8 0xff 0x10 0x00 
0x44 0x00 0xde 0xff 0x08 0x00 0x28 0x00 0x0a 0x00 0xf2 0xff 0x0e 0x00 0x3c 0x00 0x0a 0x00 0xe2 0xff 0x34 0x00 0x30 0x00 0x1e 0x00 0x0e 0x00 0x1a 0x00 0xce 0xff 
0x20 0x00 0xfa 0xff 0x50 0x00 0x2a 0x00 0x1a 0x00 0x38 0x00 0xd0 0xff 0x08 0x00 0x26 0x00 0xe2 0xff 0x0c 0x00 0x30 0x00 0xe0 0xff 0x0e 0x00 0xbc 0xff 0xb6 0xff 
0xc4 0xff 0xfa 0xff 0x1c 0x00 0x28 0x00 0x0c 0x00 0x42 0x00 0xd6 0xff 0x22 0x00 0x26 0x00 0xea 0xff 0x0c 0x00 0x30 0x00 0xb6 0xff 0x0e 0x00 0xbe 0xff 0x10 0x00 
0xba 0xff 0xe8 0xff 0x04 0x00 0x18 0x00 0xcc 0xff 0x46 0x00 0x08 0x00 0x22 0x00 0x3c 0x00 0xec 0xff 0x2c 0x00 0x12 0x00 0xba 0xff 0x2c 0x00 0xbe 0xff 0xda 0xff 
0xaa 0xff 0x34 0x00 0x2c 0x00 0x36 0x00 0xd0 0xff 0xf0 0xff 0x3a 0x00 0x3a 0x00 0x0e 0x00 0x04 0x00 0x3a 0x00 0x10 0x00 0xce 0xff 0xf2 0xff 0xe0 0xff 0xde 0xff 
0xd4 0xff 0x42 0x00 0x2c 0x00 0x36 0x00 0xda 0xff 0xe8 0xff 0x36 0x00 0x3a 0x00 0x0e 0x00 0x1e 0x00 0x2c 0x00 0xc6 0xff 0x1e 0x00 0x32 0x00 0xbe 0xff 0xea 0xff 
0x20 0x00 0xfa 0xff 0xe8 0xff 0x0e 0x00 0x1a 0x00 0xea 0xff 0x0e 0x00 0x08 0x00 0x0a 0x00 0x10 0x00 0x14 0x00 0x08 0x00 0x3a 0x00 0xfe 0xff 0xf0 0xff 0x2e 0x00 
0xcc 0xff 0x0e 0x00 0x24 0x00 0x32 0x00 0x1a 0x00 0x0a 0x00 0x08 0x00 0x08 0x00 0x0a 0x00 0xec 0xff 0xac 0xff 0xf2 0xff 0xfa 0xff 0xfe 0xff 0xbc 0xff 0x10 0x00 
0xc4 0xff 0x0e 0x00 0xca 0xff 0x18 0x00 0x1a 0x00 0x38 0x00 0x3a 0x00 0x22 0x00 0x0e 0x00 0xec 0xff 0xba 0xff 0x10 0x00 0xd6 0xff 0xf2 0xff 0xbe 0xff 0x10 0x00 
0xba 0xff 0x0e 0x00 0xf8 0xff 0x06 0x00 0x0c 0x00 0x42 0x00 0x08 0x00 0x22 0x00 0x0e 0x00 0xf2 0xff 0x2c 0x00 0xf2 0xff 0xd6 0xff 0xf2 0xff 0xbe 0xff 0xda 0xff 
0xb0 0xff 0x26 0x00 0xf8 0xff 0xf8 0xff 0xf2 0xff 0xf0 0xff 0xf8 0xff 0x1a 0x00 0x0e 0x00 0x04 0x00 0x30 0x00 0xca 0xff 0xde 0xff 0xec 0xff 0xdc 0xff 0xde 0xff 
0xb0 0xff 0x08 0x00 0x04 0x00 0x06 0x00 0xcc 0xff 0xaa 0xff 0xf6 0xff 0x18 0x00 0x16 0x00 0x16 0x00 0x2c 0x00 0xc6 0xff 0xde 0xff 0x24 0x00 0xc2 0xff 0xea 0xff 
0x20 0x00 0x34 0x00 0xe8 0xff 0x0e 0x00 0x2c 0x00 0xc0 0xff 0x30 0x00 0xe6 0xff 0xf8 0xff 0xf8 0xff 0x14 0x00 0x3a 0x00 0x3a 0x00 0xfe 0xff 0xf0 0xff 0x20 0x00 
0xcc 0xff 0x1c 0x00 0xe8 0xff 0x18 0x00 0x1a 0x00 0xc0 0xff 0x22 0x00 0x08 0x00 0xf8 0xff 0x10 0x00 0xdc 0xff 0xf2 0xff 0x28 0x00 0xd4 0xff 0xbc 0xff 0x20 0x00 
0xba 0xff 0x0e 0x00 0xca 0xff 0xe4 0xff 0x1a 0x00 0x34 0x00 0x50 0x00 0x04 0x00 0x26 0x00 0x36 0x00 0xdc 0xff 0xf2 0xff 0xfa 0xff 0xf2 0xff 0xbe 0xff 0xda 0xff 
0xba 0xff 0xe8 0xff 0xfe 0xff 0xf8 0xff 0xc0 0xff 0x48 0x00 0x08 0x00 0x2c 0x00 0x48 0x00 0x04 0x00 0x2a 0x00 0xf2 0xff 0xdc 0xff 0xf4 0xff 0xdc 0xff 0xd8 0xff 
0xe0 0xff 0xe8 0xff 0xfe 0xff 0xe4 0xff 0xf2 0xff 0x34 0x00 0xf0 0xff 0xf6 0xff 0x0e 0x00 0x04 0x00 0x30 0x00 0xa4 0xff 0xde 0xff 0xf2 0xff 0x0c 0x00 0x3e 0x00 
0xb8 0xff 0x06 0x00 0xfe 0xff 0xe6 0xff 0xd2 0xff 0xac 0xff 0xd0 0xff 0xf6 0xff 0x3c 0x00 0x0c 0x00 0x14 0x00 0xa4 0xff 0x0c 0x00 0xfc 0xff 0x0c 0x00 0x06 0x00 
0xf0 0xff 0x20 0x00 0x10 0x00 0x02 0x00 0x26 0x00 0x50 0x00 0x66 0x00 0xd8 0xff 0x3a 0x00 0xe6 0xff 0xf0 0xff 0xfa 0xff 0x42 0x00 0x14 0x00 0xee 0xff 0xe8 0xff 
0x0c 0x00 0x20 0x00 0xec 0xff 0x02 0x00 0xf4 0xff 0x16 0x00 0x66 0x00 0xe0 0xff 0x0e 0x00 0xe6 0xff 0x16 0x00 0xf8 0xff 0x28 0x00 0xd2 0xff 0x30 0x00 0xf8 0xff 
0xf0 0xff 0x16 0x00 0xcc 0xff 0x2c 0x00 0xc0 0xff 0x12 0x00 0x4c 0x00 0xea 0xff 0x0e 0x00 0xd4 0xff 0xf0 0xff 0xec 0xff 0x22 0x00 0x42 0x00 0x32 0x00 0x0a 0x00 
0x1a 0x00 0x16 0x00 0xec 0xff 0xf4 0xff 0xc0 0xff 0x16 0x00 0x10 0x00 0xf8 0xff 0xf2 0xff 0xfc 0xff 0xfa 0xff 0x08 0x00 0xe0 0xff 0x4e 0x00 0xee 0xff 0xf8 0xff 
0x1a 0x00 0x16 0x00 0x2a 0x00 0xe4 0xff 0xc8 0xff 0x12 0x00 0xcc 0xff 0xf6 0xff 0xea 0xff 0xfc 0xff 0xd4 0xff 0x0c 0x00 0xe2 0xff 0x4e 0x00 0xd0 0xff 0xde 0xff 
0x1a 0x00 0x12 0x00 0x2a 0x00 0xd8 0xff 0xd6 0xff 0xf6 0xff 0xcc 0xff 0xf0 0xff 0xf2 0xff 0x1a 0x00 0xe0 0xff 0x18 0x00 0xe2 0xff 0x4e 0x00 0xd2 0xff 0xe2 0xff 
0xe6 0xff 0xd6 0xff 0x0a 0x00 0x12 0x00 0x26 0x00 0x18 0x00 0x32 0x00 0xb6 0xff 0x1a 0x00 0xea 0xff 0xe8 0xff 0x06 0x00 0x12 0x00 0xe6 0xff 0xc6 0xff 0xf8 0xff 
0xf0 0xff 0xe2 0xff 0xec 0xff 0x3e 0x00 0x26 0x00 0x18 0x00 0x38 0x00 0xb6 0xff 0x0e 0x00 0xdc 0xff 0xf0 0xff 0x06 0x00 0x12 0x00 0xd2 0xff 0xee 0xff 0x1e 0x00 
0xd4 0xff 0xe2 0xff 0xca 0xff 0x30 0x00 0xfe 0xff 0x16 0x00 0x32 0x00 0xde 0xff 0x18 0x00 0xb6 0xff 0xe8 0xff 0xec 0xff 0x12 0x00 0xf0 0xff 0x22 0x00 0xf8 0xff 
0x0c 0x00 0xf4 0xff 0xdc 0xff 0x02 0x00 0xc6 0xff 0x3a 0x00 0xd2 0xff 0xf8 0xff 0x0e 0x00 0xb6 0xff 0xe0 0xff 0x08 0x00 0x12 0x00 0x02 0x00 0xde 0xff 0xf2 0xff 
0x1a 0x00 0x22 0x00 0xec 0xff 0xe4 0xff 0xda 0xff 0x3a 0x00 0xd2 0xff 0xde 0xff 0x0a 0x00 0xc6 0xff 0xc4 0xff 0xf2 0xff 0xe0 0xff 0x4e 0x00 0xd0 0xff 0xde 0xff 
0x1a 0x00 0x24 0x00 0xdc 0xff 0xe4 0xff 0x06 0x00 0xea 0xff 0xdc 0xff 0xf0 0xff 0xea 0xff 0xfc 0xff 0xbc 0xff 0xfc 0xff 0xfe 0xff 0x4e 0x00 0xd0 0xff 0xe2 0xff 
0xe6 0xff 0xde 0xff 0xcc 0xff 0x02 0x00 0x26 0x00 0xf2 0xff 0x30 0x00 0xd8 0xff 0xfa 0xff 0x3e 0x00 0xe8 0xff 0x1c 0x00 0x12 0x00 0xe6 0xff 0xc6 0xff 0x04 0x00 
0xf0 0xff 0xf4 0xff 0xf4 0xff 0x12 0x00 0x1c 0x00 0xf2 0xff 0x38 0x00 0xf0 0xff 0x18 0x00 0xe6 0xff 0xf6 0xff 0x06 0x00 0x2c 0x00 0xe6 0xff 0xee 0xff 0x34 0x00 
0xdc 0xff 0xf4 0xff 0xc4 0xff 0x04 0x00 0x18 0x00 0xf2 0xff 0x18 0x00 0xca 0xff 0x18 0x00 0xb6 0xff 0xe8 0xff 0x08 0x00 0x12 0x00 0xf0 0xff 0x0a 0x00 0xd2 0xff 
0xf6 0xff 0xf4 0xff 0xca 0xff 0x30 0x00 0x1c 0x00 0x16 0x00 0xdc 0xff 0xde 0xff 0x0a 0x00 0xb4 0xff 0xe0 0xff 0x08 0x00 0x12 0x00 0xf0 0xff 0x0a 0x00 0xd2 0xff 
0xfa 0xff 0x20 0x00 0xdc 0xff 0x34 0x00 0x06 0x00 0x16 0x00 0xea 0xff 0xec 0xff 0x0a 0x00 0xc4 0xff 0xa2 0xff 0xec 0xff 0x12 0x00 0xea 0xff 0xe8 0xff 0xcc 0xff 
0x10 0x00 0xfe 0xff 0xf6 0xff 0xfa 0xff 0x06 0x00 0xea 0xff 0xea 0xff 0x0c 0x00 0x0a 0x00 0xea 0xff 0xbc 0xff 0xf2 0xff 0xfe 0xff 0xcc 0xff 0xbe 0xff 0xcc 0xff 
0xe6 0xff 0xd4 0xff 0xc8 0xff 0xda 0xff 0x18 0x00 0xee 0xff 0x18 0x00 0xb6 0xff 0xfa 0xff 0x20 0x00 0xf6 0xff 0xfa 0xff 0xf4 0xff 0xd2 0xff 0xd6 0xff 0x1a 0x00 
0xde 0xff 0xc0 0xff 0x06 0x00 0x12 0x00 0x1c 0x00 0xca 0xff 0x0a 0x00 0xc4 0xff 0x18 0x00 0xdc 0xff 0xfa 0xff 0xfa 0xff 0x14 0x00 0xe6 0xff 0x0a 0x00 0x3e 0x00 
0xdc 0xff 0xbe 0xff 0xc4 0xff 0x04 0x00 0x18 0x00 0xee 0xff 0xc0 0xff 0xc4 0xff 0x08 0x00 0xd2 0xff 0x20 0x00 0xfa 0xff 0x12 0x00 0xea 0xff 0x0a 0x00 0x34 0x00 
0xea 0xff 0xc0 0xff 0xf4 0xff 0x3e 0x00 0x22 0x00 0xc2 0xff 0xd2 0xff 0xde 0xff 0x08 0x00 0xac 0xff 0x20 0x00 0x04 0x00 0x12 0x00 0xea 0xff 0x0a 0x00 0xd2 0xff 
0xfa 0xff 0x06 0x00 0x34 0x00 0x42 0x00 0x06 0x00 0xe2 0xff 0xea 0xff 0xec 0xff 0x08 0x00 0xc4 0xff 0xa2 0xff 0xf2 0xff 0x12 0x00 0xc0 0xff 0x34 0x00 0xe2 0xff 
0xf2 0xff 0x06 0x00 0x34 0x00 0xc4 0xff 0xf6 0xff 0xe2 0xff 0xea 0xff 0x08 0x00 0xe6 0xff 0xc4 0xff 0xa0 0xff 0xf2 0xff 0x18 0x00 0xb0 0xff 0x34 0x00 0xf2 0xff 
0xde 0xff 0xde 0xff 0xce 0xff 0xde 0xff 0x02 0x00 0xba 0xff 0x14 0x00 0x04 0x00 0x20 0x00 0xf2 0xff 0xdc 0xff 0xfa 0xff 0x14 0x00 0xd2 0xff 0x0e 0x00 0x16 0x00 
0xd4 0xff 0xc0 0xff 0x08 0x00 0x04 0x00 0x02 0x00 0xc2 0xff 0x0a 0x00 0xc4 0xff 0xe2 0xff 0xdc 0xff 0xfa 0xff 0xec 0xff 0x22 0x00 0xf8 0xff 0x0a 0x00 0x0a 0x00 
0xdc 0xff 0xc0 0xff 0x06 0x00 0x2a 0x00 0x10 0x00 0xce 0xff 0xea 0xff 0x04 0x00 0x08 0x00 0xde 0xff 0xfe 0xff 0xec 0xff 0x2c 0x00 0xf8 0xff 0x0a 0x00 0xd2 0xff 
0xea 0xff 0x12 0x00 0x0a 0x00 0x2e 0x00 0x10 0x00 0xc2 0xff 0xea 0xff 0x06 0x00 0xf8 0xff 0xde 0xff 0x20 0x00 0x04 0x00 0x22 0x00 0xf8 0xff 0x0a 0x00 0xd2 0xff 
0xfa 0xff 0x06 0x00 0x4a 0x00 0x34 0x00 0x0c 0x00 0xe2 0xff 0x1a 0x00 0x04 0x00 0x08 0x00 0xde 0xff 0x02 0x00 0xf8 0xff 0x30 0x00 0xc0 0xff 0x34 0x00 0x0e 0x00 
0xf2 0xff 0xfa 0xff 0x34 0x00 0xd6 0xff 0xf0 0xff 0xde 0xff 0xf2 0xff 0x06 0x00 0xf8 0xff 0xde 0xff 0x02 0x00 0xd0 0xff 0x2a 0x00 0xb0 0xff 0x34 0x00 0x0e 0x00 
0x26 0x00 0x08 0x00 0xce 0xff 0xde 0xff 0xb0 0xff 0xba 0xff 0x0a 0x00 0xe2 0xff 0xe2 0xff 0xf2 0xff 0xdc 0xff 0x16 0x00 0x04 0x00 0xca 0xff 0x16 0x00 0xc4 0xff 
0xde 0xff 0x2a 0x00 0xf0 0xff 0xde 0xff 0xea 0xff 0xbc 0xff 0x0a 0x00 0xe2 0xff 0xb4 0xff 0xea 0xff 0xdc 0xff 0x04 0x00 0x04 0x00 0x06 0x00 0x10 0x00 0xc4 0xff 
0xe0 0xff 0x16 0x00 0x06 0x00 0x2e 0x00 0x10 0x00 0xce 0xff 0x14 0x00 0x18 0x00 0x08 0x00 0xea 0xff 0xdc 0xff 0xec 0xff 0xfe 0xff 0x2a 0x00 0x10 0x00 0xc4 0xff 
0xf0 0xff 0x16 0x00 0x06 0x00 0x2a 0x00 0x14 0x00 0xc2 0xff 0x1a 0x00 0x08 0x00 0x08 0x00 0xea 0xff 0x02 0x00 0x04 0x00 0xfe 0xff 0x2a 0x00 0x08 0x00 0xf2 0xff 
0x12 0x00 0x06 0x00 0x34 0x00 0x2e 0x00 0x10 0x00 0xe2 0xff 0x24 0x00 0x04 0x00 0x10 0x00 0xf0 0xff 0xf8 0xff 0xf8 0xff 0x0c 0x00 0xe4 0xff 0x08 0x00 0xf4 0xff 
0xf2 0xff 0xfa 0xff 0xec 0xff 0xc4 0xff 0xf0 0xff 0xde 0xff 0x22 0x00 0xc0 0xff 0x34 0x00 0xf8 0xff 0xf8 0xff 0xf8 0xff 0x2a 0x00 0x16 0x00 0x48 0x00 0x04 0x00 
0xd4 0xff 0x30 0x00 0x08 0x00 0xf8 0xff 0xc0 0xff 0x2c 0x00 0x0c 0x00 0x34 0x00 0xb8 0xff 0xa4 0xff 0x04 0x00 0x26 0x00 0xde 0xff 0xe8 0xff 0xf2 0xff 0x3a 0x00 
0xf0 0xff 0xc6 0xff 0xee 0xff 0xdc 0xff 0xd4 0xff 0x32 0x00 0x0c 0x00 0x06 0x00 0xd2 0xff 0xca 0xff 0x04 0x00 0x1e 0x00 0x0e 0x00 0xac 0xff 0xda 0xff 0x1c 0x00 
0xf0 0xff 0xc6 0xff 0xee 0xff 0xdc 0xff 0xd4 0xff 0xf0 0xff 0xd8 0xff 0x06 0x00 0xfa 0xff 0xd0 0xff 0xd2 0xff 0x38 0x00 0x14 0x00 0xb2 0xff 0xec 0xff 0xfc 0xff 
0xf8 0xff 0x1a 0x00 0xe6 0xff 0xdc 0xff 0xf4 0xff 0xf0 0xff 0xee 0xff 0x1e 0x00 0xd2 0xff 0xe0 0xff 0xd2 0xff 0xfe 0xff 0xd8 0xff 0x3a 0x00 0xe8 0xff 0xfc 0xff 
0xcc 0xff 0x52 0x00 0xd0 0xff 0xfc 0xff 0xf4 0xff 0xe0 0xff 0xe4 0xff 0x02 0x00 0xf6 0xff 0xe0 0xff 0x04 0x00 0xf4 0xff 0xb2 0xff 0x3a 0x00 0x2e 0x00 0xe6 0xff 
0xe4 0xff 0xfa 0xff 0x0c 0x00 0x30 0x00 0xf4 0xff 0xfe 0xff 0x0c 0x00 0xcc 0xff 0x10 0x00 0xec 0xff 0x08 0x00 0xe0 0xff 0xca 0xff 0x2c 0x00 0x28 0x00 0xda 0xff 
0xf0 0xff 0x30 0x00 0x08 0x00 0x1a 0x00 0xf2 0xff 0x0e 0x00 0x0c 0x00 0x06 0x00 0xb8 0xff 0xc0 0xff 0x14 0x00 0x1e 0x00 0xfa 0xff 0xce 0xff 0x08 0x00 0xea 0xff 
0xf8 0xff 0xf8 0xff 0xe6 0xff 0x1a 0x00 0xf8 0xff 0x0e 0x00 0x26 0x00 0x06 0x00 0xd2 0xff 0xca 0xff 0x04 0x00 0x1e 0x00 0x14 0x00 0xce 0xff 0xec 0xff 0xea 0xff 
0xf0 0xff 0xee 0xff 0xd2 0xff 0xdc 0xff 0xf4 0xff 0xfa 0xff 0xd8 0xff 0x06 0x00 0xfa 0xff 0x12 0x00 0xc4 0xff 0x2c 0x00 0x3c 0x00 0xe8 0xff 0x36 0x00 0xfc 0xff 
0xf8 0xff 0xf8 0xff 0xd0 0xff 0xfc 0xff 0xf8 0xff 0xfa 0xff 0x26 0x00 0x18 0x00 0x06 0x00 0x16 0x00 0xb6 0xff 0x08 0x00 0xe0 0xff 0x2c 0x00 0x3a 0x00 0xfc 0xff 
0xf8 0xff 0x1a 0x00 0xd0 0xff 0xfc 0xff 0xd4 0xff 0xe2 0xff 0xde 0xff 0x02 0x00 0x06 0x00 0x16 0x00 0xb6 0xff 0xf6 0xff 0xe0 0xff 0x2c 0x00 0x44 0x00 0xf0 0xff 
0xf0 0xff 0x04 0x00 0xe4 0xff 0x30 0x00 0x10 0x00 0xcc 0xff 0x0c 0x00 0xcc 0xff 0x24 0x00 0x1a 0x00 0x04 0x00 0xe2 0xff 0xce 0xff 0x2c 0x00 0x28 0x00 0xc0 0xff 
0xfe 0xff 0xb8 0xff 0xd6 0xff 0x02 0x00 0xda 0xff 0x0e 0x00 0xe8 0xff 0x3a 0x00 0xc0 0xff 0xc0 0xff 0x5c 0x00 0xec 0xff 0xde 0xff 0xe8 0xff 0x2c 0x00 0xea 0xff 
0xf8 0xff 0xf8 0xff 0xfe 0xff 0xdc 0xff 0xf8 0xff 0x0e 0x00 0x0c 0x00 0xbc 0xff 0xfa 0xff 0xc0 0xff 0x5c 0x00 0x08 0x00 0xfa 0xff 0xe8 0xff 0x02 0x00 0xea 0xff 
0xe0 0xff 0xf8 0xff 0x06 0x00 0xdc 0xff 0xf8 0xff 0xf0 0xff 0x08 0x00 0xe0 0xff 0xfa 0xff 0x16 0x00 0xf8 0xff 0x2a 0x00 0xe0 0xff 0xf6 0xff 0x2e 0x00 0x18 0x00 
0xe0 0xff 0xf8 0xff 0xe4 0xff 0x12 0x00 0xf8 0xff 0xfa 0xff 0xe4 0xff 0x02 0x00 0xfa 0xff 0x16 0x00 0xd2 0xff 0x2a 0x00 0xe0 0xff 0x08 0x00 0x2e 0x00 0x08 0x00 
0xbe 0xff 0xf8 0xff 0xe4 0xff 0x12 0x00 0xce 0xff 0xfe 0xff 0xe4 0xff 0xe0 0xff 0xf6 0xff 0x16 0x00 0x04 0x00 0xf6 0xff 0xe0 0xff 0xf6 0xff 0x2e 0x00 0xf0 0xff 
0xbe 0xff 0xf2 0xff 0xe4 0xff 0x12 0x00 0xd4 0xff 0x0c 0x00 0x0c 0x00 0x18 0x00 0xf0 0xff 0xf2 0xff 0x26 0x00 0xe2 0xff 0xec 0xff 0xf0 0xff 0x14 0x00 0xe2 0xff 
0xfe 0xff 0xbe 0xff 0xd6 0xff 0xca 0xff 0xae 0xff 0x0e 0x00 0xe8 0xff 0xe6 0xff 0xfe 0xff 0xf4 0xff 0x46 0x00 0xe0 0xff 0xe8 0xff 0xc0 0xff 0x28 0x00 0x0c 0x00 
0xf6 0xff 0xf8 0xff 0xde 0xff 0x9c 0xff 0xf8 0xff 0x0e 0x00 0xc4 0xff 0xbc 0xff 0xfe 0xff 0xee 0xff 0x46 0x00 0xec 0xff 0x48 0x00 0xce 0xff 0xf4 0xff 0xfa 0xff 
0xe0 0xff 0xf8 0xff 0xfe 0xff 0xca 0xff 0xfe 0xff 0xfa 0xff 0xc4 0xff 0xe0 0xff 0xfa 0xff 0x16 0x00 0x24 0x00 0x08 0x00 0x48 0x00 0x08 0x00 0x36 0x00 0xfa 0xff 
0xe0 0xff 0xf8 0xff 0xfe 0xff 0x1e 0x00 0xfe 0xff 0x0c 0x00 0xb4 0xff 0xe0 0xff 0x06 0x00 0x16 0x00 0xf6 0xff 0x2a 0x00 0x3a 0x00 0x2c 0x00 0x3a 0x00 0x08 0x00 
0xbe 0xff 0xf8 0xff 0x20 0x00 0x1e 0x00 0xd4 0xff 0x14 0x00 0xd0 0xff 0xe0 0xff 0x06 0x00 0xf2 0xff 0xc6 0xff 0x44 0x00 0x06 0x00 0xf6 0xff 0x44 0x00 0xf0 0xff 
0xb6 0xff 0xfe 0xff 0x08 0x00 0x12 0x00 0xd4 0xff 0x14 0x00 0xec 0xff 0x14 0x00 0x06 0x00 0xec 0xff 0x26 0x00 0xe2 0xff 0x12 0x00 0xd6 0xff 0x28 0x00 0x08 0x00 
0xf8 0xff 0x1a 0x00 0xd6 0xff 0xbe 0xff 0xb0 0xff 0x3e 0x00 0x14 0x00 0xfa 0xff 0x06 0x00 0x20 0x00 0x4e 0x00 0xb6 0xff 0xe8 0xff 0xf2 0xff 0x02 0x00 0x10 0x00 
0xf8 0xff 0x36 0x00 0xfe 0xff 0x9c 0xff 0xfe 0xff 0x26 0x00 0xc6 0xff 0xca 0xff 0x06 0x00 0x08 0x00 0x60 0x00 0xe0 0xff 0x0c 0x00 0x08 0x00 0xe6 0xff 0xd2 0xff 
0xec 0xff 0x24 0x00 0x06 0x00 0x9c 0xff 0x0c 0x00 0xec 0xff 0xf8 0xff 0xe6 0xff 0xfa 0xff 0x12 0x00 0x48 0x00 0x2a 0x00 0x0c 0x00 0x08 0x00 0x02 0x00 0xce 0xff 
0xe6 0xff 0x1c 0x00 0x4e 0x00 0x12 0x00 0x0c 0x00 0xec 0xff 0xc4 0xff 0xe0 0xff 0xfa 0xff 0xee 0xff 0x28 0x00 0x42 0x00 0x3a 0x00 0x2a 0x00 0xe2 0xff 0xee 0xff 
0xe4 0xff 0xfe 0xff 0xee 0xff 0x1e 0x00 0x26 0x00 0x0c 0x00 0xd0 0xff 0x06 0x00 0xe4 0xff 0xf2 0xff 0xf6 0xff 0x4a 0x00 0x06 0x00 0x18 0x00 0xe2 0xff 0x08 0x00 
0xbe 0xff 0x10 0x00 0x08 0x00 0x0a 0x00 0x26 0x00 0x42 0x00 0xec 0xff 0x14 0x00 0xf6 0xff 0xec 0xff 0x26 0x00 0xec 0xff 0x06 0x00 0x0c 0x00 0xe2 0xff 0x1c 0x00 
0xf8 0xff 0x38 0x00 0xe4 0xff 0xbe 0xff 0xb0 0xff 0xf0 0xff 0x18 0x00 0xe6 0xff 0x04 0x00 0x26 0x00 0x54 0x00 0xa6 0xff 0x04 0x00 0xee 0xff 0x1a 0x00 0x4e 0x00 
0xf8 0xff 0x38 0x00 0x14 0x00 0xbe 0xff 0xb0 0xff 0xea 0xff 0xf8 0xff 0xca 0xff 0x06 0x00 0x20 0x00 0x54 0x00 0xae 0xff 0x0c 0x00 0xee 0xff 0xe4 0xff 0xd0 0xff 
0xf8 0xff 0x38 0x00 0x0e 0x00 0xe2 0xff 0xfe 0xff 0xc0 0xff 0x20 0x00 0x06 0x00 0x02 0x00 0x1a 0x00 0x48 0x00 0x28 0x00 0x3a 0x00 0xe8 0xff 0xe2 0xff 0xce 0xff 
0x32 0x00 0x1c 0x00 0x14 0x00 0x1e 0x00 0x32 0x00 0xb6 0xff 0xee 0xff 0x06 0x00 0x3c 0x00 0x08 0x00 0x44 0x00 0x42 0x00 0x3a 0x00 0xfc 0xff 0xe2 0xff 0xee 0xff 
0xec 0xff 0x1c 0x00 0x0e 0x00 0x1e 0x00 0x26 0x00 0x20 0x00 0xc0 0xff 0x06 0x00 0x0c 0x00 0xec 0xff 0xf4 0xff 0x44 0x00 0x08 0x00 0xfc 0xff 0xe2 0xff 0xf4 0xff 
0xf0 0xff 0x1c 0x00 0x16 0x00 0x0a 0x00 0x24 0x00 0x28 0x00 0xd0 0xff 0xd0 0xff 0x14 0x00 0xec 0xff 0xda 0xff 0xf8 0xff 0x02 0x00 0x0c 0x00 0x28 0x00 0x26 0x00 
0xf4 0xff 0xe2 0xff 0x10 0x00 0xe6 0xff 0xd0 0xff 0x1c 0x00 0xe6 0xff 0x06 0x00 0x04 0x00 0x20 0x00 0x20 0x00 0xf2 0xff 0x34 0x00 0xd6 0xff 0x12 0x00 0x0a 0x00 
0xf4 0xff 0xe2 0xff 0x10 0x00 0x26 0x00 0xf0 0xff 0x1c 0x00 0xe6 0xff 0x06 0x00 0xdc 0xff 0x20 0x00 0x20 0x00 0x0a 0x00 0x02 0x00 0x06 0x00 0x1e 0x00 0x4e 0x00 
0x10 0x00 0xe0 0xff 0x10 0x00 0x08 0x00 0x0c 0x00 0x12 0x00 0x1e 0x00 0xe2 0xff 0xdc 0xff 0x02 0x00 0x20 0x00 0x4c 0x00 0x02 0x00 0x14 0x00 0x04 0x00 0x36 0x00 
0x50 0x00 0xd0 0xff 0x0a 0x00 0x08 0x00 0x0c 0x00 0xf6 0xff 0xf8 0xff 0xe2 0xff 0x22 0x00 0xe6 0xff 0x2e 0x00 0x4c 0x00 0x08 0x00 0x5c 0x00 0x02 0x00 0x36 0x00 
0x30 0x00 0xfa 0xff 0x1c 0x00 0x04 0x00 0xea 0xff 0x12 0x00 0xd8 0xff 0xe0 0xff 0x56 0x00 0xda 0xff 0x2e 0x00 0x3a 0x00 0x0c 0x00 0x56 0x00 0x02 0x00 0xfe 0xff 
0x30 0x00 0x22 0x00 0x0a 0x00 0x04 0x00 0xe4 0xff 0xc2 0xff 0xe8 0xff 0xe4 0xff 0x56 0x00 0xd8 0xff 0x42 0x00 0x02 0x00 0xfe 0xff 0x0e 0x00 0x10 0x00 0xee 0xff 
0xee 0xff 0xe2 0xff 0xfa 0xff 0xfa 0xff 0xbc 0xff 0x1c 0x00 0x08 0x00 0x3a 0x00 0x14 0x00 0xf6 0xff 0x20 0x00 0x1c 0x00 0x34 0x00 0x02 0x00 0x14 0x00 0xe2 0xff 
0x10 0x00 0xe2 0xff 0x0c 0x00 0x20 0x00 0xae 0xff 0x2e 0x00 0xe6 0xff 0xe6 0xff 0x04 0x00 0x02 0x00 0x28 0x00 0xf0 0xff 0x02 0x00 0x06 0x00 0x1e 0x00 0xf2 0xff 
0x10 0x00 0xe2 0xff 0x0c 0x00 0x08 0x00 0xae 0xff 0x1c 0x00 0xee 0xff 0xe6 0xff 0x04 0x00 0xee 0xff 0x26 0x00 0x1c 0x00 0xee 0xff 0x02 0x00 0x14 0x00 0x36 0x00 
0x28 0x00 0xfa 0xff 0x0a 0x00 0x08 0x00 0x0c 0x00 0x26 0x00 0xee 0xff 0xe6 0xff 0xfe 0xff 0xe6 0xff 0x3a 0x00 0x0a 0x00 0x02 0x00 0x3a 0x00 0xb0 0xff 0x32 0x00 
0x28 0x00 0x16 0x00 0xf8 0xff 0x08 0x00 0xea 0xff 0x26 0x00 0xee 0xff 0xc8 0xff 0xec 0xff 0xda 0xff 0x2e 0x00 0x04 0x00 0x0c 0x00 0x0e 0x00 0xb0 0xff 0xea 0xff 
0x20 0x00 0x22 0x00 0xb8 0xff 0x14 0x00 0xe4 0xff 0x26 0x00 0xfa 0xff 0xc8 0xff 0xec 0xff 0xe6 0xff 0xe0 0xff 0x02 0x00 0xfe 0xff 0x2e 0x00 0xf2 0xff 0xcc 0xff 
0xee 0xff 0x0e 0x00 0x0c 0x00 0x3a 0x00 0x06 0x00 0x14 0x00 0x08 0x00 0x20 0x00 0x08 0x00 0xf6 0xff 0x3c 0x00 0xf6 0xff 0x06 0x00 0x02 0x00 0x16 0x00 0xfc 0xff 
0x10 0x00 0xe2 0xff 0x2c 0x00 0x3a 0x00 0xae 0xff 0x2e 0x00 0x0a 0x00 0x14 0x00 0xb0 0xff 0x02 0x00 0x20 0x00 0xe4 0xff 0x06 0x00 0x02 0x00 0x16 0x00 0x22 0x00 
0x24 0x00 0xd6 0xff 0x36 0x00 0x32 0x00 0xa2 0xff 0x26 0x00 0x0a 0x00 0xd0 0xff 0xc0 0xff 0x02 0x00 0x20 0x00 0x0a 0x00 0x06 0x00 0xf8 0xff 0x04 0x00 0x3c 0x00 
0x28 0x00 0xd0 0xff 0xf8 0xff 0xfe 0xff 0xaa 0xff 0x26 0x00 0xee 0xff 0x14 0x00 0xf0 0xff 0xee 0xff 0x2e 0x00 0x0a 0x00 0xfe 0xff 0xfa 0xff 0xac 0xff 0x30 0x00 
0x28 0x00 0x04 0x00 0xf4 0xff 0xd6 0xff 0xe8 0xff 0xe4 0xff 0x0c 0x00 0xc8 0xff 0xec 0xff 0xda 0xff 0x2e 0x00 0x04 0x00 0x0a 0x00 0xe6 0xff 0xb0 0xff 0x18 0x00 
0xaa 0xff 0x16 0x00 0xf4 0xff 0xd6 0xff 0xe8 0xff 0xe4 0xff 0x0c 0x00 0xb2 0xff 0xf0 0xff 0x1c 0x00 0xd4 0xff 0x04 0x00 0xf0 0xff 0xf2 0xff 0xb0 0xff 0xda 0xff 
0xfc 0xff 0xe2 0xff 0x16 0x00 0x50 0x00 0x1c 0x00 0x14 0x00 0x0a 0x00 0xd0 0xff 0x14 0x00 0xf6 0xff 0x1c 0x00 0x18 0x00 0xdc 0xff 0x02 0x00 0x2c 0x00 0xfc 0xff 
0x24 0x00 0xda 0xff 0x2e 0x00 0x32 0x00 0x06 0x00 0x14 0x00 0x0a 0x00 0xe6 0xff 0xfe 0xff 0xf0 0xff 0x1c 0x00 0xe8 0xff 0xfe 0xff 0x02 0x00 0x14 0x00 0x22 0x00 
0x26 0x00 0xda 0xff 0x36 0x00 0x3a 0x00 0xae 0xff 0xfe 0xff 0xee 0xff 0xe6 0xff 0xfe 0xff 0xee 0xff 0xd0 0xff 0x0a 0x00 0xe2 0xff 0x0e 0x00 0xf4 0xff 0x44 0x00 
0x40 0x00 0xf6 0xff 0xf4 0xff 0xfe 0xff 0x14 0x00 0xe4 0xff 0xee 0xff 0x44 0x00 0xfe 0xff 0x0c 0x00 0xe6 0xff 0xd0 0xff 0xea 0xff 0xfa 0xff 0xdc 0xff 0x30 0x00 
0x40 0x00 0x16 0x00 0xea 0xff 0xd6 0xff 0xec 0xff 0xfe 0xff 0x0c 0x00 0x20 0x00 0xfc 0xff 0xd4 0xff 0xe6 0xff 0xfe 0xff 0xe2 0xff 0xf4 0xff 0xec 0xff 0x18 0x00 
0x16 0x00 0x24 0x00 0xea 0xff 0xd6 0xff 0xec 0xff 0x30 0x00 0x1a 0x00 0xce 0xff 0x30 0x00 0x08 0x00 0xa6 0xff 0xfe 0xff 0xca 0xff 0xf4 0xff 0x28 0x00 0xda 0xff 
0x0a 0x00 0xd6 0xff 0x4c 0x00 0x50 0x00 0x38 0x00 0x14 0x00 0x32 0x00 0x20 0x00 0xee 0xff 0xf0 0xff 0x1c 0x00 0x04 0x00 0xf8 0xff 0x0e 0x00 0x2c 0x00 0x26 0x00 
0x24 0x00 0xd6 0xff 0x48 0x00 0x32 0x00 0x10 0x00 0x14 0x00 0x14 0x00 0x40 0x00 0xee 0xff 0xf4 0xff 0x1a 0x00 0xde 0xff 0xfe 0xff 0xda 0xff 0xf4 0xff 0x30 0x00 
0x24 0x00 0xd6 0xff 0x36 0x00 0x32 0x00 0xf4 0xff 0xb6 0xff 0xd2 0xff 0x40 0x00 0xee 0xff 0x0c 0x00 0xe6 0xff 0xde 0xff 0xd8 0xff 0x0e 0x00 0xf4 0xff 0x44 0x00 
0xee 0xff 0xee 0xff 0x0e 0x00 0xfe 0xff 0x22 0x00 0xb6 0xff 0xd2 0xff 0x44 0x00 0x0e 0x00 0x2a 0x00 0xaa 0xff 0xee 0xff 0x0a 0x00 0xfa 0xff 0xdc 0xff 0x3c 0x00 
0x16 0x00 0x04 0x00 0x0e 0x00 0xac 0xff 0x1e 0x00 0xe4 0xff 0x0c 0x00 0x12 0x00 0xfc 0xff 0xe8 0xff 0xe6 0xff 0x08 0x00 0x0a 0x00 0xf4 0xff 0xf2 0xff 0x54 0x00 
0xee 0xff 0x2e 0x00 0xf4 0xff 0xc0 0xff 0x22 0x00 0xe6 0xff 0x1a 0x00 0xf8 0xff 0x30 0x00 0xe8 0xff 0xba 0xff 0x0a 0x00 0xd2 0xff 0xe4 0xff 0x2a 0x00 0x42 0x00 
0x08 0x00 0xca 0xff 0x58 0x00 0xe2 0xff 0x3a 0x00 0x2a 0x00 0x34 0x00 0x32 0x00 0xee 0xff 0xae 0xff 0x1a 0x00 0x66 0x00 0xda 0xff 0x18 0x00 0x0c 0x00 0x26 0x00 
0x46 0x00 0xd4 0xff 0x48 0x00 0x08 0x00 0x30 0x00 0x02 0x00 0x14 0x00 0x40 0x00 0x22 0x00 0xfc 0xff 0xec 0xff 0x2c 0x00 0xd8 0xff 0x0e 0x00 0xf4 0xff 0x26 0x00 
0x02 0x00 0xda 0xff 0x1c 0x00 0x14 0x00 0x4c 0x00 0x02 0x00 0xd2 0xff 0x40 0x00 0x10 0x00 0x34 0x00 0xe6 0xff 0x0a 0x00 0xd8 0xff 0x2e 0x00 0x0c 0x00 0x46 0x00 
0xee 0xff 0xee 0xff 0xf2 0xff 0x14 0x00 0x22 0x00 0xb8 0xff 0xbe 0xff 0x44 0x00 0x38 0x00 0x50 0x00 0xc0 0xff 0xee 0xff 0x08 0x00 0x2a 0x00 0xf4 0xff 0x46 0x00 
0x02 0x00 0xea 0xff 0x0e 0x00 0xf2 0xff 0x0a 0x00 0xfe 0xff 0x12 0x00 0x20 0x00 0xfc 0xff 0xfc 0xff 0xe6 0xff 0x0a 0x00 0x24 0x00 0xf4 0xff 0x2a 0x00 0x56 0x00 
0x38 0x00 0x2e 0x00 0x0e 0x00 0xf2 0xff 0xec 0xff 0xea 0xff 0x1a 0x00 0x1c 0x00 0x0e 0x00 0xd8 0xff 0xf2 0xff 0x0a 0x00 0xd2 0xff 0x9a 0xff 0xf2 0xff 0x4a 0x00 
